W W W W W W W W W W W W W W W W W W W W W W W W W W W W
W W W W . . . . . . . W W W W W W W W W . . . W W W . W
W W W W . . . . . . . W W W W W . . . W . . . W W W . W
W W W . . . . . . . . . . W . . . . . W . . W W W . . W
W W W . . . W . . W . . . W . . . W W W . W W . . . W W
W W W . W . . . . . . W . W W . W W W W . . . . W W W W
W W W . . . . . . . . . . W . . . . W W . W W W W W W W
W W W . W . W . W . W . W W . . . W W W . . . . . . . W
W W W . . . . . . . . . . W W . W W W W W W W W W W . W
W W W . . . . . . . . . . . . . . . . W W W W W . . . W
W . . . . . W W W W W W W W W W W W . . W W W W . W W W
W . W W W W W W W . W W W W . . W W W . W W . . . . . W
W . W W W W W W W . W W W W . . . W W . W . . . W W W W
W . . . . W W W . . . W W W W . . W . . . . W W W W W W
W W W W . W . . . . . . . W W W . . . W W . W W W W W W
W W W W . W W W . . . W W W W W W W . W W . . . . W W W
W . . . . . . . W . W W W . . . W W . W W W W . . W W W
W . W . W . W . W . W W W . P . W W . . . W W W . W W W
W . . . . . . . . . . . W . . . W W W . . W . . . . . W
W W W W W W W W W . W W W W . W W . . . . W W W . W W W
W . . . . W W W W . W W . . . . W . W W W W W W . W W W
W . W W W W W . . . . . . W . . . . . . W W W . . W W W
W . . . . . . . . W . . . . . W . W . . . . . . . . . W
W W W W W W W W W W W W W W W W W W W W W W W W W W W W
